Script started on 2024-04-08 15:25:25-04:00
bash-4.4$ cd
bash-4.4$ ls
cs131
bash-4.4$ cd 131[K[K[K[K[K[Ktouch .bash_profile
bash-4.4$ ls
cs131
bash-4.4$ vi[K[Kvi .bash_profile
[?2004h[?1049h[22;0;0t[?1h=[?2004h[1;24r[?12h[?12l[27m[23m[29m[m[H[2J[?25l[24;1H".bash_profile" 0L, 0C[2;1H[94m~                                                                               [3;1H~                                                                               [4;1H~                                                                               [5;1H~                                                                               [6;1H~                                                                               [7;1H~                                                                               [8;1H~                                                                               [9;1H~                                                                               [10;1H~                                                                               [11;1H~                                                                               [12;1H~                                                                               [13;1H~                                                                               [14;1H~                                                                               [15;1H~                                                                               [16;1H~                                                                               [17;1H~                                                                               [18;1H~                                                                               [19;1H~                                                                               [20;1H~                                                                               [21;1H~                                                                               [22;1H~                                                                               [23;1H~                                                                               [1;1H[?25h[?25l[m[24;1H[1m-- INSERT --[m[24;13H[K[1;1H[?25h[?25ll[?25h[?25li[?25h[?25la[?25h[?25ls[?25h[?25l [?25h[?25ll[?25h[?25l=[?25h[?25l'[?25h[?25lls[?25h[?25l [?25h[?25l-[?25h[?25ll[?25h[?25lt[?25h[?25lr[?25h[?25l'[?25h[?25l[2;1H[K[2;1H[?25h[1;1H[?25lalias l='ls -ltr'a[?25h
[?25la[?25h[?25ll[?25h[?25li[?25h[?25la[?25h[?25ls[?25h[?25l [?25h[?25lw[?25h[?25l [?25h[?25l[?25h[?25l=[?25h[?25l'[?25h[?25ll[?25h[?25ls[?25h[?25l [?25h[?25l-[?25h[?25ll[?25h[?25l [?25h[?25l|[?25h[?25l [?25h[?25lw[?25h[?25lc[?25h[?25l'[?25h[?25l`[?25h[?25l[2;21H[K[2;21H[?25h[24;1H[K[2;20H[?25l[?25h[?25l[24;1H:[?2004h[?25hx[?25l[?2004l".bash_profile" 2L, 39C written
[?2004l[?1l>[?25h[?1049l[23;0;0tbash-4.4$ ls
cs131
bash-4.4$ source .[K~/.bash_profile
bash-4.4$ l
total 4
drwxrwxr-x 9 piercesp24 piercesp24 4096 Apr  8 15:16 cs131
bash-4.4$ w
      2      11      67
bash-4.4$ ls
cs131
bash-4.4$ ls -l | wc
      2      11      67
bash-4.4$ ls -ltr
total 4
drwxrwxr-x 9 piercesp24 piercesp24 4096 Apr  8 15:16 cs131
bash-4.4$ ls
cs131
bash-4.4$ cd cs131
bash-4.4$ ls
Assignment1  Assignment2  Worksheet1  Worksheet2  Worksheet3  Worksheet4
bash-4.4$ cd WOrksh[K[K[K[K[Korksheet4
bash-4.4$ mkdir Subscribers
bash-4.4$ ls
Subscribers  ws4.txt
bash-4.4$ cd Subscribers[K[K[K[K[K[K[K[K[K[K[K[K[K[Kwget https://raw.githubusercontent.com/jyotikahp/DemoRepoForCS131/main//Global%20YouTube%20Statistics.csv
--2024-04-08 15:50:12--  https://raw.githubusercontent.com/jyotikahp/DemoRepoForCS131/main/Global%20YouTube%20Statistics.csv
Resolving raw.githubusercontent.com (raw.githubusercontent.com)... 185.199.108.133, 185.199.110.133, 185.199.109.133, ...
Connecting to raw.githubusercontent.com (raw.githubusercontent.com)|185.199.108.133|:443... connected.
HTTP request sent, awaiting response... 200 OK
Length: 200279 (196K) [text/plain]
Saving to: ‘Global YouTube Statistics.csv’

          Global Yo   0%[                    ]       0  --.-KB/s               Global YouTube Stat 100%[===================>] 195.58K  --.-KB/s    in 0.01s   

2024-04-08 15:50:12 (18.7 MB/s) - ‘Global YouTube Statistics.csv’ saved [200279/200279]

bash-4.4$ ls
'Global YouTube Statistics.csv'   Subscribers   ws4.txt
bash-4.4$ ls
'Global YouTube Statistics.csv'   Subscribers   ws4.txt
bash-4.4$ awk '{ total += $0; count++ } END { print total/count }' Subscribers/unnited_states.txt > ws4_means.txt
awk: fatal: cannot open file `Subscribers/united_states.txt' for reading (No such file or directory)
bash-4.4$ awk '{ total += $0; count++ } END { print total/count }' Subscribers/unnited_states.txt > ws4_means.txt[A[C[C[C[C[C[C[C[C[C[C[C[C[C[C[C[C[C[C[C[C[C[C[C[C[C[C[C[C[C[C[C[C[C[C[C[C[C[C[C[C[C[C[C[C[C[C[C[C[C[C[C[C[C[C[C[C[C[C[C[C[C[C[C[C[C[C[C[C[C[C[C[C[C[C[C[C[C[C[C[C[C[C[C[C[C[C[C[C[C[K
[K[A[C[C[C[C[C[C[C[C[C[Cawk -F, '$8== "United States" { print $3 }' "Global YouTube Statistics..csv" >  subscribers/united_states.txt[C[1Pubscribers/united_states.txt[C[C[C[C[C[C[C[C[CSubscribers/united_states.txt[C[C[C[C[C[C[C[C[C[C
bash-4.4$ awk -F, '$8== "India" { print $3 }' "Global YouTube Statistics.csv" > ssubscribers/india.txt[A[C[C[C[CUnited States" { print $3 }' "Global YouTube Statistics.csv" >  Subscribers/united_states.txt[C[AIndia" { print $3 }' "Global YouTube Statistics.csv" > s[17Pubscribers/india.txt[1Pubscribers/india.txtSubscribers/india.txt[C
bash-4.4$ ls
'Global YouTube Statistics.csv'   Subscribers   ws4_means.txt   ws4.txt
bash-4.4$ Subscribers
bash: Subscribers: command not found
bash-4.4$ ls d[K[K[K[Kcd [K Subscribers
bash-4.4$ ls
india.txt  united_states.txt
bash-4.4$ cat india.txt
245000000
159000000
96700000
83000000
70500000
65900000
65600000
64600000
61000000
59300000
58000000
57600000
57200000
54600000
53300000
47400000
45500000
42500000
41400000
39200000
38300000
38200000
37200000
37000000
36600000
35500000
35500000
35400000
34300000
34000000
33500000
33500000
33400000
32700000
32000000
31700000
31700000
30700000
30500000
29800000
28900000
28400000
28300000
28200000
27300000
27100000
26400000
26300000
25200000
24300000
23400000
23100000
23100000
23000000
23000000
22900000
22600000
22600000
22500000
21600000
21400000
21300000
21300000
21300000
20900000
20400000
20400000
20200000
20000000
19500000
19400000
19400000
19300000
19200000
19000000
18800000
18600000
17800000
17700000
17500000
17500000
17500000
17300000
17300000
17000000
16900000
16900000
16600000
16600000
16600000
16500000
16300000
16000000
15800000
15800000
15700000
15700000
15700000
15700000
15500000
15500000
15400000
15300000
15300000
15200000
15200000
15200000
15200000
15200000
15200000
15000000
15000000
15000000
15000000
15000000
14700000
14700000
14600000
14500000
14500000
14500000
14400000
14400000
14400000
14400000
14200000
14200000
14200000
14100000
14000000
14000000
13900000
13800000
13800000
13700000
13700000
13700000
13700000
13700000
13600000
13500000
13500000
13500000
13400000
13400000
13400000
13300000
13300000
13200000
13200000
13200000
13100000
13000000
12800000
12700000
12500000
12500000
12500000
12500000
12500000
12500000
12500000
12400000
12400000
12400000
12400000
12300000
12300000
bash-4.4$ awk '{ total += $0; count++ } END { print total/count }' Subscribers/unnited_states.txt > ws4_means.txt[K[K[K[K[K[K[K[K[K[K[K[K[K[K[K[K[K[K[K[K[K[K[K[K[K[K[K[K[K[K[K[K[A[C[C[C[C[C[C[C[C[C[C[C[C[C[C[C[C[C[C[C[C[C[C[C[C[C[C[C[C[C[C[C[C[C[C[C[C[C[C[C[C[C[C[C[C[C[C[C[C[C[C[C[C[C[C[C[C[C[C[C[C[C[C[C[C[C[C[C[C[C[C[C[C[C[C[C[C[C[C[C[K
[K[A[C[C[C[C[C[C[C[C[C[C[C[C[C[C[C[C[C[C[C[C[C[C[C[C[C[C[C[C[C[C[C[C[C[C[C[C[C[C[C[C[C[C[C[C[C[C[C[C[C[C[C[C[C[C[C[C[C[C[C[C[C[C[C[C[C[C[C[C[C[C[C[C[C[C[C[C[C[C[C[K[K[K[K[K[K[K[K[K[K[K[K[K[K[K[K[K[K[K[K[K[K[K[K[K[K[K[K[K[K[K[K[K[K[K[K[K[K[K[K[K[K[K[K[K[K[K[K[K[K[K[K[K[K[K[K[K[K[K[K[K[K[K[K[K[K[K[K[K.
bash: .: filename argument required
.: usage: . filename [arguments]
bash-4.4$ ..
bash: ..: command not found
bash-4.4$ ls[K[Kls
india.txt  united_states.txt
bash-4.4$ cd.[K .
bash-4.4$ ls
india.txt  united_states.txt
bash-4.4$ cd ..
bash-4.4$ s[Kls
'Global YouTube Statistics.csv'   Subscribers   ws4_means.txt   ws4.txt
bash-4.4$ awk '{ total += $0; count++ } END { print total/count }' Subscribers/unnited_states.txt > ws4_means.txt
bash-4.4$ awk '{ total += $0; count++ } END { print total/count }' Subscribers/inndia.txt >> ws4_means.txt
bash-4.4$ ls[K[Kcd [K[K[Kcd Subscribers
bash-4.4$ ls
india.txt  united_states.txt
bash-4.4$ cd[Kat india.txt
245000000
159000000
96700000
83000000
70500000
65900000
65600000
64600000
61000000
59300000
58000000
57600000
57200000
54600000
53300000
47400000
45500000
42500000
41400000
39200000
38300000
38200000
37200000
37000000
36600000
35500000
35500000
35400000
34300000
34000000
33500000
33500000
33400000
32700000
32000000
31700000
31700000
30700000
30500000
29800000
28900000
28400000
28300000
28200000
27300000
27100000
26400000
26300000
25200000
24300000
23400000
23100000
23100000
23000000
23000000
22900000
22600000
22600000
22500000
21600000
21400000
21300000
21300000
21300000
20900000
20400000
20400000
20200000
20000000
19500000
19400000
19400000
19300000
19200000
19000000
18800000
18600000
17800000
17700000
17500000
17500000
17500000
17300000
17300000
17000000
16900000
16900000
16600000
16600000
16600000
16500000
16300000
16000000
15800000
15800000
15700000
15700000
15700000
15700000
15500000
15500000
15400000
15300000
15300000
15200000
15200000
15200000
15200000
15200000
15200000
15000000
15000000
15000000
15000000
15000000
14700000
14700000
14600000
14500000
14500000
14500000
14400000
14400000
14400000
14400000
14200000
14200000
14200000
14100000
14000000
14000000
13900000
13800000
13800000
13700000
13700000
13700000
13700000
13700000
13600000
13500000
13500000
13500000
13400000
13400000
13400000
13300000
13300000
13200000
13200000
13200000
13100000
13000000
12800000
12700000
12500000
12500000
12500000
12500000
12500000
12500000
12500000
12400000
12400000
12400000
12400000
12300000
12300000
bash-4.4$ ls
india.txt  united_states.txt
bash-4.4$ cd ..
bash-4.4$ awk '{ total += $0; count++ } END { print total/count }' Subscribers/inndia.txt >> ws4_means.txt
bash-4.4$ ls
'Global YouTube Statistics.csv'   Subscribers   ws4_means.txt   ws4.txt
bash-4.4$ cd[K[Kls[K[Kcat ws4_means.txt
2.34169e+07
2.56583e+07
2.56583e+07
bash-4.4$ vi ws4_means.txt
[?2004h[?1049h[22;0;0t[?1h=[?2004h[1;24r[?12h[?12l[27m[23m[29m[m[H[2J[?25l[24;1H"ws4_means.txt" 3L, 36C[1;1H2.34169e+07
2.56583e+07
2.56583e+07
[94m~                                                                               [5;1H~                                                                               [6;1H~                                                                               [7;1H~                                                                               [8;1H~                                                                               [9;1H~                                                                               [10;1H~                                                                               [11;1H~                                                                               [12;1H~                                                                               [13;1H~                                                                               [14;1H~                                                                               [15;1H~                                                                               [16;1H~                                                                               [17;1H~                                                                               [18;1H~                                                                               [19;1H~                                                                               [20;1H~                                                                               [21;1H~                                                                               [22;1H~                                                                               [23;1H~                                                                               [1;1H[?25h[?25l[1;23r[m[1;1H[2M[1;24r[22;1H[94m~                                                                               [23;1H~                                                                               [m[24;1H[K[1;1H[?25h[?25l[1;1H[K[24;1H--No lines in buffer--[1;1H[?25h[?25l[24;1H[K[24;1H:[?2004h[?25hq[?25l[97m[41mE37: No write since last change (add ! to override)[?2004h[1;1H[?25h[?25l[m[24;1H[K[24;1H:[?2004h[?25hq[?25l[97m[41mE37: No write since last change (add ! to override)[?2004h[1;1H[?25h[?25l[m[24;1H[K[24;1H:[?2004h[?25h!q[?25l:!q[?2004l[?1l>[?25h[?1049l[23;0;0t
[No write since last change]
[?2004l/bin/bash: q: command not found
[?2004h
shell returned 127

Press ENTER or type command to continue[?1049h[22;0;0t[?1h=[?2004h[?25l[24;1H[K[24;1H:[?2004h.![?25h[?25l[24;3H[K[24;3H[?25h[?25l[24;2H[K[24;2H[?25h [27m[23m[29m[m[H[2J[?25l[2;1H[94m~                                                                               [3;1H~                                                                               [4;1H~                                                                               [5;1H~                                                                               [6;1H~                                                                               [7;1H~                                                                               [8;1H~                                                                               [9;1H~                                                                               [10;1H~                                                                               [11;1H~                                                                               [12;1H~                                                                               [13;1H~                                                                               [14;1H~                                                                               [15;1H~                                                                               [16;1H~                                                                               [17;1H~                                                                               [18;1H~                                                                               [19;1H~                                                                               [20;1H~                                                                               [21;1H~                                                                               [22;1H~                                                                               [23;1H~                                                                               [1;1H[?25h[?25l[24;1H[m:[?2004h[?25hq[?25l[97m[41mE37: No write since last change (add ! to override)[?2004h[1;1H[?25h[?25l[m[24;1H[K[24;1H:[?2004h[?25hq[?25l[24;2H[K[24;2H[?25h!q[?25l:!q[?2004l[?1l>[?25h[?1049l[23;0;0t
[No write since last change]
[?2004l/bin/bash: q: command not found
[?2004h
shell returned 127

Press ENTER or type command to continue[?1049h[22;0;0t[?1h=[?2004h[27m[23m[29m[m[H[2J[?25l[2;1H[94m~                                                                               [3;1H~                                                                               [4;1H~                                                                               [5;1H~                                                                               [6;1H~                                                                               [7;1H~                                                                               [8;1H~                                                                               [9;1H~                                                                               [10;1H~                                                                               [11;1H~                                                                               [12;1H~                                                                               [13;1H~                                                                               [14;1H~                                                                               [15;1H~                                                                               [16;1H~                                                                               [17;1H~                                                                               [18;1H~                                                                               [19;1H~                                                                               [20;1H~                                                                               [21;1H~                                                                               [22;1H~                                                                               [23;1H~                                                                               [1;1H[?25h[?25l[24;1H[m:[?2004h[?25h1[?25l[24;2H[K[24;2H[?25h [1;1H[?25l[24;1H:[?2004h[?25hq[?25l[97m[41mE37: No write since last change (add ! to override)[?2004h[1;1H[?25h[?25l[m[24;1H[K[24;1H:[?2004h[?25h!q[?25l[24;3H[K[24;3H[?25hw[?25l[24;3H[K[24;3H[?25h[?25l[24;2H[K[24;2H[?25hq!@[?25l[24;4H[K[24;4H[?25h[?25l[?2004l[?2004l[?1l>[?25h[?1049l[23;0;0t
bash-4.4$ ls
'Global YouTube Statistics.csv'   Subscribers   ws4_means.txt   ws4.txt
bash-4.4$ ws[K[Kvi ws4_means.txt
[?2004h[?1049h[22;0;0t[?1h=[?2004h[1;24r[?12h[?12l[27m[23m[29m[m[H[2J[?25l[24;1H"ws4_means.txt" 3L, 36C[1;1H2.34169e+07
2.56583e+07
2.56583e+07
[94m~                                                                               [5;1H~                                                                               [6;1H~                                                                               [7;1H~                                                                               [8;1H~                                                                               [9;1H~                                                                               [10;1H~                                                                               [11;1H~                                                                               [12;1H~                                                                               [13;1H~                                                                               [14;1H~                                                                               [15;1H~                                                                               [16;1H~                                                                               [17;1H~                                                                               [18;1H~                                                                               [19;1H~                                                                               [20;1H~                                                                               [21;1H~                                                                               [22;1H~                                                                               [23;1H~                                                                               [1;1H[?25h

[?25l~                                                                               [2;1H[?25h[?25l[m[24;1H[K[24;1H:[?2004h[?25hx[?25l[?2004l"ws4_means.txt" 2L, 24C written
[?2004l[?1l>[?25h[?1049l[23;0;0tbash-4.4$ ls
'Global YouTube Statistics.csv'   Subscribers   ws4_means.txt   ws4.txt
bash-4.4$ cat ws4_means.txt
2.34169e+07
2.56583e+07
bash-4.4$ sed -i 's/Hello/Hi/g' greetings.txt
sed: can't read greetings.txt: No such file or directory
bash-4.4$ vi greetings.txt
[?2004h[?1049h[22;0;0t[?1h=[?2004h[1;24r[?12h[?12l[27m[23m[29m[m[H[2J[?25l[24;1H"greetings.txt" [New File][2;1H[94m~                                                                               [3;1H~                                                                               [4;1H~                                                                               [5;1H~                                                                               [6;1H~                                                                               [7;1H~                                                                               [8;1H~                                                                               [9;1H~                                                                               [10;1H~                                                                               [11;1H~                                                                               [12;1H~                                                                               [13;1H~                                                                               [14;1H~                                                                               [15;1H~                                                                               [16;1H~                                                                               [17;1H~                                                                               [18;1H~                                                                               [19;1H~                                                                               [20;1H~                                                                               [21;1H~                                                                               [22;1H~                                                                               [23;1H~                                                                               [1;1H[?25h[?25l[m[24;1H[1m-- INSERT --[m[24;13H[K[1;1H[?25h[?25lHello, John Doe!
Hi, Jane Doe![2;14H[K[3;1HGreetings, John Smith![3;23H[K[4;1HHello, Mi[4;10H[K[4;10H[?25h[?25lchael Johnson!
Hi, Emily Davis![5;17H[K[6;1H[K[6;1H[?25h[?25l`[?25h[?25l[6;1H[K[6;1H[?25h[24;1H[K[6;1H[?25l[?25h[?25l[24;1H:[?2004h[?25h [6;1H[5;16H
[?25l[24;1H[1m-- INSERT --[m[7;1H[K[7;1H[?25h[?25l[94m~                                                                               [6;1H[?25h[?25l~                                                                               [5;17H[?25h[m[24;1H[K[5;16H[?25l[?25h[?25l[24;1H:[?2004h[?25hx[?25l[?2004l"greetings.txt" [New] 5L, 95C written
[?2004l[?1l>[?25h[?1049l[23;0;0tbash-4.4$ Hello, John Doe!
bash: Hello,: command not found
bash-4.4$ Hi, Jane Doe!
bash: Hi,: command not found
bash-4.4$ Greetings, John Smith!
bash: Greetings,: command not found
bash-4.4$ Hello, Michael Johnson!
bash: Hello,: command not found
bash-4.4$ Hi, Emily Davis!
bash: Hi,: command not found
bash-4.4$ sed -i 's/Hello/Hi/g' greetings.txt
bash-4.4$ sed -i '/Doe/d' greetings.txt
bash-4.4$ sed -i 's/$/(edited)/' greetings.txt
bash-4.4$ sed -i '/^Hi/s/Michael Johnson/Mike Johnson/' greetings.txt
bash-4.4$ ls
'Global YouTube Statistics.csv'   Subscribers	  ws4.txt
 greetings.txt			  ws4_means.txt
bash-4.4$ cat gretings.t[K[K[K[K[K[K[Ketings.txt
Greetings, John Smith!(edited)
Hi, Mike Johnson!(edited)
Hi, Emily Davis!(edited)
bash-4.4$ exit

Script done on 2024-04-08 16:22:50-04:00
